######################################################################################################
#      \\    \   \        \                      \           \               \       \       \      \#
# \                                 \    \      \   \         \      \                               #
#                                           \         \    \\   \     \   \                      \   #
#               \                          \ \              \        \               \  \            #
#     \         \        \   \            \           \            \                       \         #
#        \                          \                \ \        \                               \    #
#   R   \                                   \    \             \       \     \  \\    \     \  \     #
# \           A                       \      \  \                               \   \     \          #
#                     \ \  \                           \                  \                        \ #
#\      \ \              \            \                        \ \\ \              \                 #
#         \       \      \          \          \\       \  \ \        \   \   \      \               #
#                 \     \ \                             \ C                     \     \              #
#    \ \      \    \       \     \         \              \         \        \ \                     #
#  \                               \\\ \        \         \          \ \              \         \    #
#                         \                             \     \           \                          #
#       \\ \     \     \            \ \      \   \   \               \  \  \                         #
#                   \                  \  \     \                                  \           \     #
#      \                 \\                                    \           \             \   \      \#
#       \                                                                   \       \\   \      \   \#
#                 \      \\ \     \                    \                          \                  #
#              \     \                               \                  \          \\ \          \   #
#     \ \ \              \     \     \    \  \            \    \    \      \         \      \      \ #
#  \ \  \  \         \                            \  \   \\                                          #
#               \\  \     \         \   \   \          \  \\         \    \      \      \ \       \  #
#   \        \          \                     \ \ \    \ 2\  \     \          \      \\   \    \     #
#                          \       \                \    \    \                                      #
#                   \\      \     \                         \      \   \                       \\    #
# \ \            \    \\ \   \                           \                        L               \  #
#   \                1                      \             \  \  \                                    #
# \             \ \ \  \\\ \      \                        \    \                   \\\           \  #
#              \\\                          \                      \     \\ \         \        \   \ #
#  \           \                  \ \\        \                   \   \   \                         \#
#    \                       \                  \    \ \       \     \    \               \          #
#        \                  \  \     \  \          \   \         \   \     \                         #
#                \              \\   \ \    \   \                        \\         \                #
#       \                         \\    \      \              \                 \                    #
# \  \           \                    B         \       \                            \  \            #
#     \     \                 \       \  \                   \   \                                   #
#       \                           \\                    \             \                 \          #
#\      \        \                                                  \  \ \                   \       #
#          \         \ \      \        \    \             \    \  \    \              \         \    #
# \                \        \        \      \  \            \                           \ \      \   #
#           \      \     \   \   \    \     \       \               3\                 \             #
#                    \           \                       \     \\                    \               #
#                    \        \                   \        \ \          \                  \    \\   #
#        \                         \        \                \  \       \             \\             #
#                                 \           \   \                 \\\                         \    #
#    \\          \  \   \                 \       \              \             \\   \        \  \    #
#        \    \       \\   \  \  \  \       \              \     \        \                          #
#  \   \     \  \                                         \      \                                   #
#       \         \ \ \              \   \                  \           \  \            \         \  #
# \\ \      \           \           \\\    \       \     \                \       \  \         \     #
#                                    \   \     \                         \ D      \\                 #
#       \                             \   \        \    \          \                 \        \ \   \#
#             \  \    \    \      \   \                       \       \                         \    #
#         \        \   \         \                    \      \ \         \\    \     \  \      \  \  #
#          \      \    \                                      \ \                           \        #
#                                          \    \    \                                      \        #
#             \\\       \       \                 \  \                        \     \                #
#    \              \    \     \                               \ \\               \       \        \\#
#\\\     \     \                          \                        \    \          \         \       #
#           \       \            \       \                \       \                             \  \ #
#                        \       \                   \                         \            \  \\    #
#                         \     \       \         \ \         \               \         \            #
#  \             \                                            \\                   \           \     #
#              \\\                    \                                \        \           \        #
#     \  \ \ \                 \        \    \    \      \\      \       \                \       \  #
#                     \\       \                                   \ \   \  \    \   \           \   #
# \ \ \        \     \      \                  \                     \              \         \  \   #
# \               \         \ \ \     \                                \            \ \              #
#         \                     \ \         \\      \        \                     \                 #
#                       \          \    \ \                                                        \ #
# \          \                        4            \             \               \         \  \      #
#\            \          \ \\         \              \  \     \      \    \\                         #
#        \      \                \  \\  \                 \        \                   \ \           #
#  \                      \ \            \                   \      \                              \\#
#\\        \     \        \  \             \   \         \      \                   \ \\       \     #
#                        \            \           \\  \  \   \               \                       #
#     \                       \         \              \      \            \                         #
#                                \        \        \        \   \                      \      \      #
# \   \               \             \ \  \          \ \                    \              \          #
# \       \ \  \     \                        \              \\      \                          \    #
# \  \  \  \                         \                                   \         \     \           #
#   \                   \                   \               \   \   \                 \    \      \  #
#      \   \  \                           \      \                                \       \         \#
#   \   \                               \      \       \   \        \        \    \      \  \        #
#                                                    \    \         \\             \    \            #
#      \              \   \      \                             \                 \                  \#
#        \                               \                \                         \       \        #
#                                     \    \      \   \  \    \               \          \  \        #
#     \        \   \                                        \                         \\             #
# \                \ \     \           \   \   \               \   \    \                            #
#      \                \  \  \       \\ \           \ \      \       \ \        \    \     \        #
# \                            \  \ \   \                    \               \           \           #
#                                               \       \\    \     \                                #
#            \           \    \        \  \                      \ \           \  \     \          \\#
#        \                     \  \                                              \  \                #
#  \      \         \    \        \             \                            \           \        \ \#
#                                \           \                                             \         #
#                                 \   \             \    \                    \\ \          \        #
######################################################################################################

Trampoline A targets 1
Trampoline B targets 2
Trampoline C targets 3
Trampoline D targets 4
