######################################################################################################
#      .\# .*.. . ..#.#.*.#  \.##. *#.#.     *  . * .*\\   * .\* \  ...\*.*..   \  # . \...*... . ##.#
#\*. .\..#. ..*\   . # *. \..\*....*\#.# . #* . \#*  #..* .# .#.  ....*\\ .* \  ..*   . \*\. ..#..*\.#
#.# .* ..# \..#..*....  ..*#. .. # .\. . .*  ..*.  *. .\. ..... \\.*.  ...\ ..\ *..\\\#. \ .. #... .##
# #*.\. \.. *#\ * ....\\ # ..*. #. #\ .. \#... #   \.\#...*. \ .# .  \ . #  ..\.# \..\.#..  .  .# \ *#
#\*..... *#. *.... #*...*.#.* #*  ..\ ..* ...   \\...# ...  .. ..\... ## ..\.  ....\.\ .# ...    \. .#
# #  .#...#  ##\* ..*** . .##. ..* ....  .* . #*.  . .\ #..##..*\. ..  ..  . \...  \ ..##  \ ..* ..* #
# #.* . ..* ....#  ##  .  ...** \#*\.. \# ...\#  \\\.# .\.## ..*.. ## \ * . .. ....\ .. \   .*    \. #
#.* ... ...\\\**....  ...#. .# .* #... \. .# .###. #****.  ..*\ ..  \.... *....... .#.  . ... ...  *.#
#.  ....#\..\.\\* \##. .# * \* # .  .  . ###. . ...*  #. ...\. .\ .#.#  *. . .# .#..\#.. ... * *   \ #
#. #.. .   ..  .  \ \ .  .. .   .\..#.* \#   .*..# . ......  .*#..\# *.# ......    .\.\ . *  #. *\##.#
# . *##\ . \.  *..#. .  . #.\..... .#. .. \... \ . ...*. \....# \   .. .  \.#  * ##.# .\ .*\\.# *  *.#
#..\ *# .. *.\. * .   .. .. *...\   \\\\.  . *. .  ..   ..\. .#. ..  ....*\*. .\.##...\# . . .  .#  .#
#. ...* .   *. ##..\. # . .   . *. # .#\ \#\. .#.....  ###*.#.# .  .* .\\#*.. #.*..# #   .* .\..\ *..#
#  .. .    . .* ...*  *\# # .  .#\.....#. .*\...#   .#\ \  #\..  #*...... ....*  \ \\ ##. ..#..*\....#
#  # .\ .. ..*\#.\..\. ..\ *# .  #..   \.\.. *..   .# # ...*.  \#*#*..#  .. ..  \..*#..** .  .... ..\#
#. #.*#.\* .\.\#.  *.. \**  .\#.#\  # ..*. . .\.\ #..#.*. .#. \ ...  . ..  . .  .#.*\.#.  .. *..... \#
#  .... \ .   * \.#  # *  .. #.. .*##   \ . \*\. # \\*#..#\  .  *..\.*  #.\..*#*\ * .#. * .  .# ..#*\#
###.#. .....#..#  *\ . . * \. \ . .\ #*#.**..  .\.* \ . . .*#*\.  #.#*#.\ ** .*... .\ .# #\....#. . ##
# \   .\.\. . . .*..\ ...\...  \ # #*..  .#...#.* #.. .\..##\. ** ....\*  . \#\  .. .... .*..* .  * .#
#..**..# . .. .\*..#... .\L.    * .##\   . *##..... . *.\ .*.. ..  # .#.   . \. . *.*. # \.  . .. * \#
#* **... ..\. ..   .  *..*..\#..#  * . \#..**....*.\.# . #.\\*\**...#*.*.....*\..# .\  * *# #. ...#.\#
#  .*...#.\.\\#. ##\.\.    #.##...# .   *#.\.... \*..\\ *  ..\..  ... .    \.  # .. ....*.#.  \\.**..#
#. ##..  . . ..\# # .\ ## ...*    . * ...\ . .  .*# \#.  .  \.\..##...\  *.. \.* * #...*..\  #...## .#
# . \  .. .# .. \#... ** *#  \**.*#..\ .# #. .*\.. #\  .#..   ..#\  *.#. ..#.*.\\# ..* .*  .#.   ..# #
# .*.  \ .  # ..\ . .#\     .. ..    \..\. ..\...##\* *  ....#\ \.......\*.\\\ .. . #\ .  \ .\ .   . #
# *#*..*  #.\  ..* ..\* \*..   . # . \...#. . ..\ ...\...  #\#  #.\  .*.. *.\..#.#.\\\.\\... *#. .   #
#..\ #\..   .# \ \#*  ***#. .. #   #.\.... .\*.#.\ .  ....\ .... .\.    *...  . . .* \... # #..#\ #\.#
##..... * \  *.*.\#\     * . .. . .. # .\*.*  .#. . *. ...*#  ..*  #*.. \ . ..\. \  .#  .\..#\.#.** .#
#.. .\\..*..   . ..\.*\ \..* #.#..  ..*.#..#.****...\  .  *...# *. ..*# .  \.. . ..# ...*..\ *#...#*\#
# #. ...*\ #..   .   . .#.  \. *  \ . .#.* .. . ..#. *.. #*.*#...*..  \. .    .*#..  .....*.#.# *#.* #
# ... *.  \\##\ .* #.#...***# ...#\\...  .     *#\. ... * #*\..#. \..  \. .\.. .#.  ..**.# #.  \#.#\.#
##. \.\  .*. #. \\* .# .....**.  *.... # .\.. # ... #.# ..*  ## \\. .\. \.   . .. ... . \#\. #..*\#\.#
## *   *  .# ..## *#.\# ..# #. ..*...*.#.*#.\\... *... \.###  .*. # # ..  .**..\ ###\*...   *..\*..#.#
#..  . * ..\\*.# *.#. *\.\\.  *\  \ . \ * ..\. .  # ...**.*.* .*# .#\.....  .#*..*  .*..\\. #.* #.. \#
#....\.... .\ .# .\ *.#.  . \.. \\..# .*..* ..*   #\ *  .\#*\  .#.  #* \ .\ .. ...#.#.#..#... .\\ ##\#
##\ ...# ..\\  ..#..#   .#** *# *\##..*\ \ . .\*#. .. ..  #. .\#....\\.\\. \  #.* #.....#** ...  .. ##
## *..  *.    *. *..**\.    . . \. *.*#*\ ..  ..  \*..*.\. #\..*..     #  * ..\  ..  ***. .### *\ .. #
#..#   . .#... .#..  * \* . *  .\ #. *.# ##*\ ..\\.  .  .#*. . *. *.#.#\.*\. .  .\*#.. \  . .*#.\.##.#
#  \ .#   .\# **. # ..\ .\ ..  .  \. .*#..... .*...*. .\ ....\..*.#  *..\#\ \. ..##  .. .\*. \.# . #.#
#  ...*.. . . ..* ## .* .   *# .#...#\\. . ...* # *... ..#...#*# ..**\  \...# .  ........# \ .#*\\ .\#
#... ..##\. .#\.. ...*.*. .#.....   *... \.# *.. ....  #..\*.  *  .*  \##.. *.**   .#.\#  \* \. ..\ .#
#.\..# . .#. \.\# . \..# ..\# .     ##.. \..\#.....     .. . \  ..*  #*#**  #**\.\     .......#\..\  #
#  \   ** *  .. . *. .  \ . #.#.  .    *\..   . #  \* .. ...\\..# *.\ \**.\ .*. . *..\.*\#. #..*.  \ #
#.. *. .#......\...#\.  .\... ..\. . .. #\. .  .\.\. \\ ..*.\ .\\.  *..# .. # *\ .\# *. \  *..\. *...#
# .*. .... ..*..\\.  ..\# # . #.#..\# #. .#.\\ .... .\#\.#.. .   . .  .# .. \\.. .# .\ \#..*#........#
#  . .. .# ..#\ . . .#..# *  .\ ...* # ... ...\.\   **. \ \ .*.*.**.  .. \ ...  *\.  # #####.#\ \.. .#
##\.\.#####.... .\.*    \.   \ ... .\\.*. \\..#.  \ \.. *. .\.  #..#..  ..*...  #*.##.**.   *    . \ #
#\*  .# **\#\.  #* \. \.\...# .*..  #.*.\*\.* .\  *. #\ .#.*##.  \.* .#....* .\#  ...*.*  ..\\. ..   #
#\  .\.#. ..\\  #. .. *.##...* \*..\.*\*.. .\ ....\  .  ..#..\#*\. ... .*. \. .###  \..#**.. .# \. .##
# \#*  .  . . *. \** # \*. ....  \#. *  . *..\.   * .*  #*\    \ .\* ..*.. # . ..\ . *  .  .* \.*.\**#
#.. .\ ..\. ....***. . # .*. .*\.#....\ . . .. *...*#. *#\*..#..... ..* \*.# ##  .*#.  .\.. #\.  #.# #
#*.*\.. ..  .. .#.. \\  \ ** . .. .** .\\.*..*\#\  .** * .. #.*#..#  * #\ ## \..   \...\ *\ ... ..*. #
# *.*...* .#.\.\.. .. .**..** .\   .. .  \*#. .   #..\.\.*#.\.*.#..  #.#\.\\.. .. . **  ## \.  *..#..#
#.  \*. . . . \\..*. *.. . ..    #..*  *.  ... # *..**..\  #. * .\*\# ..  #... \. . .## . ... .  ..\*#
#\  \* #   .#*#\ \\\  #.#*  * *.    .#. ..  .\ .#.* . . .\.*##.#. #\*\ ..*.**.\  .... .*.\.... .. \. #
##*.. \. .#....# . . \. .... # .  #*\  . . .  #  .. \..   *..\\ ..\..# # . *. ..\.\.  \*. \\  \.\ ...#
# .  ..\#.\\....**..# . ##** .   ... .\\#\ . \  \. .. ..  #*.# #* .#\  ...*\..... **...*.\*\. ..\##* #
#. .#    .* .\ .   ..  \... .\.*. . \ .*  . .\#.*.#*..#* .. .*..*\ .\  #  . *#.... .\.*. . #   . ..*##
#**.#\ ..* .\.... .*# . .. .\\. .*  *.. \.*\.   ...  . *   .  # #..\\.  .\.. \ * # *  .* . \ ** #\# .#
#..**..  . \..\. . ..#.#.*# # ..\...* .\*  # .\#.   ..*. .\*..# *.#.  ..##  .#. \.   #...#.... *.\. \#
# ...*.. \\*..\\.*..#..\ ... .*..  ##.  .. ....*..#.\   .. **.\#*  . . \. ..... ..*.* .\\..  .\.\.  .#
#\..# .##.  ..# . .\.   #  ..#....## .\  ..     .  ..\*  \ #  .. *\.\..  . ..\ . \.... .  .* ... .  ##
#  .#\\ . ..#.**# *\#.#   .  ... \#... \.*...*..#*#*..#.\ *#\#.. .# .# ....\.#     ....#\ .. . .*. *.#
#. ...  ..\\. .#  . *#.... ...\\ ..* #... .*. .   \\ ..  \\ . *.#.. .#\ \  .\.  \\.\..*# * .   # .#..#
#*. ... \\..   .    \*\\* ..#. ..***.\.*. *\#. ## . .*.. . #      ....\ ..* .\ *.  \..*.  \  .  \...*#
#.\*\*#.....# *....\\.      #### *##..\ .\  . .  .*.\.\* ..\ . \...*.  .  ....\.*.... .. . . .* .#.#.#
# **\.\\\\... ##.. .. .. ....  *.\ .#*\.\  #. * ... *\# .. ..\........ *.\.\\\. .\\.\\*# ..\  .*#\.*.#
#  ...## .#. #*.   .# .\*.   .*.  ..  \ .#. .\.* ..\#  \.  #*\. . #...\# .. ..\. .* .   .  # .#.# .. #
#*....\\#.**\.* #..  ..\.  \ \...*...\...#*#..*. \ #. # .*. \..  \* #..##  *.    \.. #*.*..  *\ ## .*#
#\...*#..\ ..#.#..  ... *.#*# .\... .     * *..# ... ....   .. \. #. .. .\ . \..\\# .\ *.... .. #    #
#*.* #\ .. .  .*.\  .. . ..# #.    . ..\\#.. .#   .. . \. .. * . \.\ \.#\.## .  .# ... ..*.  ..*. ***#
# # .. *#..# ..  \*.. .  \* .*#...   . .. .  . *...*...# .*    \*.#....  *. . \*.  ...#...##..*.. ####
#\\#. #.   . \.. ##..#  .* ##.. .#  .. #.#*... . *#*...\   .  *.* .  .*.\  **\. .\\\ \. .... \\. #*..#
#.\#..#...#.  *. \#  *....\. \ .*..  .\\ .   .\\*...\. \#.\#\..\ .#....* \. .# \ *.  *..\.*\  # ..\#.#
##\..... . #\##*\ *   . . ...# ..#    #   #*..#....#.# .*..\ * ##   *#.*... .#.\... *#\#  .*..# . \. #
# ........*..**.  .*\##.#.\ ..* .\..   .#. ##*##*..*.# \.... #..*..*  .... . * .\ ...**\..\ . .\\... #
#  ##  ...#  *. . .... *... .* \* .  .   .. ..... .  ###...\*.. .. \ *\. \..# #.\*. *  \.# #   ......#
# ...\.*##*  . \. # ##  *# \ * \\... .. ..** #\..*. .\. ...# .  . *. \.\   ...#.... ... .\ .# # \ \\*#
#\. .#. ##. \## * *\ ## . ......#  . .  ###... .\\  .\. ..\ \**\. .\ #.#.*..#  . .#\.. **.\*...\...\\#
# #*..\. *. *......    ##.  *# .#..\    # .. #. *\.. ....*.*..#. \*#..*  \.\. .#\#...\*...* #\.\.#\  #
#  *... * \.. . . ....##. \ .. *.#*..\.\*..\.. ..*... #.  #. . #..\*    .\\. .#.. .  ..  #. . #\.  .*#
##...#..#\ #. . ..* .#....\.\ ...  .....\ .*\  ** R. ..\ ...#. ...#   \  .#\*. .*  \\.*..\.\...* *...#
#.#.\\\ .**.\... ...\*# #. . ..\   \ *\. #\..*. .* .#*#.\. * #  .* \#\. \# . .# .  .\ ..   \  * ##  \#
#   ..*\*...  . .#.#\ .\. .\.# #\... .\ .#    .\*.\\#.. #. ... *.*.. . #.\   # *.. ## ..\. .* * .#.*.#
#\  *.**..... .\.   \..  . .* \.\..    ..#..*..*.. \\.#.. .\.. ..# ..  # . . *.  ...**\*\*##  \* \ .\#
##\\ \ \#\ *     *.. ... .. .. *. ...  \..  ..\*.....##. . #.\ .\ ..... #.#. .    # .\ ..  ...*...  .#
#.. .\#.# \...\\.  \.  ...#...**. .\ #..* \..\#..  . .   .#*..**. \#  .. * . .  . . *  .* \ .  ......#
# *. .. #..*   . ...**\ ....*..\.. #...\ # . # ..  \.  *.....*.. .\.. .\ *..# * #\\.* ... . ..   .*  #
#.\*\  . #*.\...\  .\..... * ... \.\....# #\    #\ \.*   ..\.... \.. ..\ ...\## *.. *#. #\.....\\.#  #
#. .\..#.  . \ \.  .# . #*. #..* ... *\..#.. .#*\. . #*..\\ ... ..*.*#..*#.*.*. .   \\# # .*\ \.  # .#
#  . *\#**.  *.\.#.#..\ * \.#..*.. \.#\ . *  *\  .  #\ .## * .. \#\. *#..  . \. .#...#..  \..  ..* ..#
# .#.*.. .* . .*\.. .. .#.*.\\. *#  .# . #..*..#. .\* .*.# .\#.##*...\... *   ..#  . .. \#. ..#\ \  ##
#\..*. #  ..#. .* *. .\  \..# *#.. ..*\.. .*# ..   #.   *. \ .\ \.#..#.... .. .  *.. # \....#.. *....#
#\  ..#..* ......  .  . .. .. .    *. .  ..**..*...\     \ ..#   .\\...\*\    . ...\.* ###* #   .   .#
# **#.#  \ .. ...\# **.\ *.#*.\..  . * . *\*. ...*.#*..  ..   *  .#.*  . .\.  ##.*.  *  *. \ *.  ....#
#.* ...#.....*.\ *# \. **..*. ..\  . .\.\*.   .*\.. #* *.  * ..  *#    ... .#.. \*   *..\ **.* \. * \#
#...#* . .\.#.*# .\. *.#.\  . ##\.#.*\ ....#\ \#* ..# .\**  ...#* # . ..***.#  ... \ *\ *\.\.. .#  \##
#. .. . . .*# *.#..  ...** .. ..\ ..*\ . **  \ ....    ...* .#.*..**.*.. .. ..  *.. .*.. * .\.*..# ..#
#..*..* .** \   *\*... .. .*. ..* ..\   .#....*\\ .    ..  .#\.# .. ...    .   .\\   .. ..#..#...#. .#
#...\. #..#. . .*#*.... \..... * *.  #\.  *.\*. .  ..##. #.... ..  . .# .#.* ## . #  .\\*. *#  .#\...#
######################################################################################################
