######################################################################################################
#        #                           ## #        \ \\          \   \      #         # \ \       \    #
# \                \\\#     #  #\     \            \  \   \   \         \     # #               #    #
#          \               #             ##  #               \           #  \            \   \ \  ## #
#    #\   #               #\  \      #  \          \ \    #   \      \     \         #    #          #
#   ##   \  # # #          #         #  \         # \      #  #       \      #  \ #     \      \#    #
#    #    #         \    #    \ #         \    # \     #        \\ \           \   \    #      # ## \#
#    \  \        \\  ##           #    #    \    #\ \  #    ##         \              \\\#  \     \  #
##              \  #    \                    \   #                  \ \#      #     #                #
#     \ \   \ \  \         \      #   #          \  \ \\         #\           \   #              #  \#
#    \ #       #          \    #\ \    #         \ ##       \  #         \       \      \   \##\  #  #
#    #           \          #  \       #          #     \                   \   #  ### \#         \  #
#   \  \\  \     \ # \#  #  \     #     #  # \   \     \#      #   \ \ \ #            \              #
#                                                           #        \ #   \ #      \ \  #      # \  #
#  \  #  \# \          \         \ # #                 \        #                \\ \             \  #
#     \ \    # #        #             #     #     \          \         #  \##   \ \       \          #
#   \# \              \ \     \                #  # #  \  \    #\    # #   #        #     \       \  #
#    # #   # \#  \     #    \  \          \\  ## #\\                    #    #   # #           #  \  #
# \         \              #  \ # # #     # \      \   \      \     \              #  R  #\        \ #
#    \    \       #\ \    \     \     \  #\ #    #\# #   #   #  #    #      \         #      #       #
#    \# #  \ #                      #     #\ #     \ \         #  #     #   \        \   \#    \    \#
#\  \             #  #      #     #   #  \      #        \   \           \        # \       \ ##     #
# \    \  \#  ###  \      #  #  ##          #\   ###     # \           \   #            \\      \\ # #
#     \   #  \  \ ###               #\#  \            #           \          L     ##   #           ##
#\     #\               \          \\      ##                   #  \#\    #          #        \      #
#      \  #  \            \     #\                    #       \            #\   #  ##      #         #
#      \  #      \        \     # #     #      \      \ \   \\  ##    \   #   \         \ \          #
#\ #     #      #       \         \ # \             \                      \     #     \ ##  \     \##
##   # #  \ \            #  \                     \     #      ##       #\    \               #      #
#  \  # #   \    \    #  \     \ \ \##       \  \  #     \    \  #      \#  \ ##\# \          \     ##
#                        #    \   \\   \ \\ \        \  ##        # # \       #              \     \ #
#          \   \   \     \       #      #      \    #  \   \  \   #     #    ##   # # \  \ \   \ \   #
#\                  #          \# \ #\          #  \\     #       # \ \    #             \   \ #     #
#                      #   # \                           \       ##   \        #   #                ##
# \    \              # \    #  # #                 \                \ \  \                      \   #
#               \\  # ##     \      \        # \             \ \ \#   #     \ \                 \ #  #
#\  \            #      \ \#   #\        #        ##  #      \\ #            \  \    \  \#           #
#      #       #             #      \     \     #                         \    \ \   ##      \#      #
#               #      \           #\ \ \                 \ #                           # #  \     # #
#       \         #   \              \ \      \     #   \   \ \        #\                 \  \ #  \  #
#        #   \     \#\       #   # #  \\   #      \#   #   \                    #  \#              ###
#       \ \         \      # \      ###           \      #                  #\   #\       #   \    #\#
#            ##   #                             #    \  #      \        #       \#       \\#         #
#  #    \        \   \ \       \              \ \     \                                 \  #         #
#   #            \   #  \#    #\          #             \    # \     #          #      \         #   #
#     \\\                    #  #      #                #  \\      #  \     ##     #\    \      # \  #
#          \  \\   \         \\  \     \\ #  #     \#       #             \                          #
#       #    #       #        #   #  #                  \  \      #           #  # #     \   \    \  #
##          \        #    \          \     \         #\  \ ##         \      \ \\              \     #
#        \ ###\                #        \  #\        # #\  \  #                     #                #
#   \       #   #  \ \       \   \            \\#\           \    #  #        \   #           \   \  #
## ## \ \       #    \#\  \           \      \                     \         ## \ # #           #    #
#        ##       #\             #   \\#       \             \      #       #      \       #         #
#            \  # \\\    #\        \\    \ ###   \    #    \       \   #                \            #
#         \    \            #                       \#   \ #        #                   #  #  \  # # #
#  \\#            # \       # \ # #           # \\ \              \     #   \\  \  #          \  #  ##
#  \                  #     #\\  \           #             \    \     #       \    #              #  #
#                    \ #  \\  \       ##              # \  \     \  #\       \\    \\ \             \#
##       #    \     \ \   \                      \  \      # #       ## # \  \      \ \    \     \ # #
# \ \ # \\# # \       #    \  \                  \   #   \\     ##      #                         \  #
# \    \  \      \                   \  # \#      #         #  \ #\      #            #              #
#  #  #          # \    #\                 ##    \     #   #    #         #       \#\        \  #  # #
#                        #            \      #   ###\            \ # #      #   \ \  #              \#
#   \ \   \\             #         #       # \#             \ #      ##        #         #     \  #  #
#\ \ \ \        \  #    \ #     ##\\     #      ##     \#\    \     # \              #               #
#                      \   #  \           \ #      \     \            #   \##             #  #     # #
# \  #\       \  \           \\        \           \        #         \     #\   \    \ \          # #
# \        \        # \            \         \# \\      \    \      # #    \    # \ #      \      \  #
#               \  #            \     ##\\ \ \      #    \              \    ##       #    #  \\ \   #
#  \   \  #                        \#\                 \      #     \   \  \\   #         #       #  #
# #  \  #\\          \\  \ \                       \       \   \ \#      \     \            #       \#
#     \       \      # ##      #                  \      \ #    # \#          \            \ \\      #
# \        #  \  \    \ \#     \         \   #       \#   \       \     \ #    #\      \ \           #
#            #\       \     \                \   #\      \      #       \ #   \    \          \\     #
# \ #   #   \            #   \                   \           # \ #       \ #            \            #
#\            \                       #           \   \# #   # \                       #  #       \ \#
# \   \  #                        \                     \ \#        \\    \   \           \#   #     #
#      \ \       # #           #    \#    \    #             \# \                  #    \ \ \    #   #
#  \\         \      # ## \          #\            #         \   \#  ## #        #     \  \  # \     #
#         #        \   #    \       \  #        #       #      #    #   \\\ \\ \  #                  #
#       \     \          \                   \             #           \#                            #
#               #   \       \              \        \       \            #   #    \   \# #  #      #\#
#      \  #     \                #     #           #            #            #\   #   #     \    #   #
#    #     \      #           # #        #       # \        \ \    #\      # \     \   #             #
#             #\   \ #    #          #     \     \              #  \\      \#      \  #       \    \ #
##    #          #  # ##  #      #\     ##        #             #               #      \#            #
#   \\     #   #         \      #  \        \                   \           #                  #   \##
#              ##   # \      \  ##\#            #           \  #   #\ # \       \   ##        \      #
#          ##  \                     \ # \\ \                 \       ##   \           ##         \# #
#          # \##           #        \    #            #    #  \      # \      \ ##   \      \        #
#  \  \            ##\       #\ \ #                #  # \       #                  \   \   \ # #     #
#    \          #    #    \  #        \          \ \     \          \#\    \   \                 \\  #
#      # \            #                             \  \          \              \  \             # ##
## #     \ #     \     \          #      #  #    \# #  \   # \\#          \     #             \\     #
#     # #        #                      \    \    #\      \     #\        \ \      #          #  \   #
#  \#  #         #   # ##         \  \#      \ #    #   \ #  #\  \#  \          #               \    #
#  \           \  \       \ \ \       \      #          \  #             ##  \              #        #
#    ##     #     #  \    \   \                    #            #  \  # \        \      #   #   \    #
## \          \         \  \      \                #    #  #                            \ #     #    #
#\      \ \ \#\  \   #          \                                ##     \        \        \ \        #
#  \\#        \        #     #                      \          # #          #          \   #\\       #
######################################################################################################
