####################
#W\\!#\\\**.\#W\\\W#
##*######..###..\\\#
#.......\.R ###...\#
#####.###.#.......##
#.......#.#\####.###
#\\##\###\#\\#...#.L
#\##\.###.####.#.#.#
#\W#####.....###.W.#
####\\...\\\...#.#.#
#W*######.######.#.#
#\\\\\\\\\.........#
############\###\###
#\\.. *..........\\#
#W... #.........##W#
####################
