#######
#     L
#\\\\\#
#\\\\\#
#R\\\\#
#\\\\\#
#######

Water 1
Flooding 6
Waterproof 0