#######
# \\\ L
#    @#
#     #
#     #
#     #
#@    #
#     #
#     #
#   @ #
#     #
# @   #
#  R  #
#######

Water 1
Flooding 12
Waterproof 0