##########
#R.....*\#
#.\\.#**\#
#.\\.#*#\#
#....#*#\#
#...*#*#\#
#.*....#\#
##L#######