###############
#R            L
#             #
#             #
#             #
#\\\\\\\\\\\\\#
###############

Water 5
Waterproof 7