###############
#\\\\##*#\\\\\#
#\\\\#* #\\\\\#
L\\\\R   \\\\\#
###############