###############
#\\\\\###\\\\\#
#L\\\R W.\\\\\#
#\\\\\###\\\\\#
###############

Growth 1
Razors 1