##########
#\\\\\\\\#
#\\\\\\\\#
#\\\\\\\\#
#\\\\\\\\#
#\\\\\\\\#
#R\\\\\\\L
##########