###     ######
#\#     #\\\\L
#R#######\\\\#
#            #
##############

Water 1
Flooding 10
Waterproof 0