#####
L*\\#
#*#\#
#*#\#
#..\#
#R\\#
#####