#############################################################
#.#....\\.............#\....#..\...\..\..\..#....\..#...\...#
#.###.#.#############.#.#.#.#.#\###########.#.###.###.#.###.#
#.\.#.#\...\..#...#...#.#.#.#\#.#.......\.#.#\..#\..#\#...#.#
###.#######\#.#.#.#####\#.###.#.###.#######.###.###.#.###\###
#.#...\..W#.#...#\.\\...#..\..#...#...\.#..\#\#\.\#.#.#.#...#
#.#######.#######.###############\#.###.#\###.###.#\#.#.###.#
#.....\.#\#...\.#.....#.#....\..#.#...#\....#.#\..#...#\..#\#
#.#\#####\#.###.#####.#.#\#\###\#.#########.#.#.#######.###\#
#\#.#...#\#.#.#.#.#\\.#...#...#.#.\.#W..#\.\..#.#.\....\#...#
#\###\#\#.#.#.#.#.#.#########.#.###.#.#.#######\###.###.#\#.#
#....\#.#...#.#.#...\.\...#\..#.#.#.#.#.#..\\.#.....#...#.#.#
#.#####.#####.#.#########.#\###.#.#.#.#.#\###.#######.###.#.#
#\#\..#..\..#.#W\..\..#.\\#.#..\..#..\#\#\#.#..\#.\.\\#.\.#.#
#.###.#.###.#.#######.###.#.#.#########.#.#.#\###.#####.###\#
#.#...#...#W..#\\...#..\#...#.#.....\.#.....#.....#...#.#..\#
#.#.#.###.###\#.###.###.#####.#.#####.#.#######.###.#.#.#####
#.\.#..\#.#...#\#\.\\\#.W...#.#.#\...W#\#.\..\#.#\..#.#\#...#
#.#####.#.#.#####.###.#####.###.#\#######\###.###.###.#.#.#.#
#\#...#.#.#.#..\..#.#.#...#.....#.#.\.\.#...#..\..#\..#..\#.#
#.#.#.###.#.###.###.#\###.#######.#.#.#\###.#######.###.###.#
#.#.#.....#.....#.\......\.\#..\..#\#.#...#\\...#.#\#...#.\.#
###.#######################.#.#######.###.#####\#.#.#####.#.#
#..\#........\..#..\#\.\..#.#...#.....#.#\......#.#.....#.#.#
#.###.#########.#\#.###.#.#.###.#.#####\#########.#####\#\#.#
#\#...#.......#...#...#.#...#.#.\.#.....#.#.\\\..\#\#...#.#.#
#\#.###\#####.#######.#.#####.#####.###.#.#.###\#.#.#.###.###
#.#.....#\.\......#..\#.....\.#.....#.#\#...#.\.#.#.#\#.#...#
#.#######W#########.###.######L.#.###\#.#####.###.#\#.#.#.#.#
#......\#.#..\\.#...#...#.......#..W#.......#.#\#W..#.#\\.#.#
#.#######.#.###.#.###.###.#########.#######.#.#\###.#.#####.#
#.\.......#.#\\.#.#\#..\#.\.#.#...#.\....\#...#\...\#.#.....#
#.#########.#.###.#\#.#####\#.#.#\#######.#####.#####.#.#####
#..\.\.\..#\#.\...#.\.#....\#\\.#.....\.#...#...#.#...#....\#
#####.#####.#W#####.###\#######.###.###.###\###.#\#.#######.#
#...#\#.....#.#...#.\\#...\...#...#\#.\.#.#...#...#........\#
#.###.#.#######.#.#\#########.#####.###.#\###\###.#########.#
#.#...#.....#\\.#\#.#..\.\..#.....#..\#...#...#\..#...#.\..\#
#.#.#######\#.###\###.###.#######.###.#####.###.###.#.#.#####
#...#\\...#\#.#.#.#.\...#W......#...#...#...#.......#.#\....#
#.###\###.#\#.#.#.#.#########.#####.###.#.#.#########.#####.#
#.#...#...#..\#.#.#\#\#.....#.#.\.#.#.\\#.#.#...#..\\.#..\..#
#.#.###.#\#####.#.#.#.#.###.#.#.#.#.#.###.###.#\#\#####.#####
#.#..\#\#.#.\...#...#.#.#.#\..#.#\..#...#.#...#\#.#.\.\.#\.\#
#\#####.#\#.#.#######.#.#.###.#.#######.#.#\###.###.#####.###
#..\#...#\#.#.\W..\...#.#....\#.#..\..#\#...#..\#..\#.......#
###.#\###\###.#.#######.#######.#\###.#.#####.###.###.#####.#
#...#...#.\.#.#...#.\\#......\..#\..#.......#.#.\.#\..#.....#
#.#####.###.###.#.#.#.#############.#####.###.#.#####.#\###.#
#\W...#\#.#...#.#...#\#\............#...\.#...#..W..#\#...#.#
#####.#.#.###.#######.#.###\#########.#####.#######.###.#.###
#...#.#.#...#.#.....#.#\#\W.#\\....\#...#.#\\.....#...#.#...#
#\###.#.###.#.#.###\#.#.#.#####.#.#####.#.#######.###.#####.#
#.....#...#\#\..#.#.#\..#.#.\.#\#.#....\#.\.\..\#...#.......#
#.#######.#\#####.#.#####.#.#.#.#.#.#######.###.###.#######\#
#.#.....#.#\.\#...#.....\.#.#\..#.#\..#.....#\#...#.#\..#.\\#
#.#.###.#.#.###.#.#########\###.#####.#W#.###.###.#.#.#.#\###
#\..#...#.#..\#.#..\..#..\.\.\#.#.....#.#...#.#...#...#..W#R#
#####\###.#.#.#.#####.#\#####.###.#########.#\#\###########.#
#\...\.W..#.#\......#.\\\..\#.\...\.........#........W\.....#
#############################################################

Razors 10