########
#\\  \\#
# \\   #
#R  \  L
########
