########           
#A \\\\############
#R \\\\           #
#  \\\\########## #
########       #B #
             #### ###
             #\\\\\\#
             #\\\\\1#
             #### ###
########        # #
L\\\\\2#        # #
#\\\\\\#        # #
#\\\\\\########## #
#                 #
###################

Trampoline A targets 1
Trampoline B targets 2