##### 
#\\\#
#\\\#
#1\\#
#####         #############
              #R          L
              #...........#
              #...........#
              #...........#
              #...........#
              #...........#
              #...........#
              #.....A.....#
              #############

Trampoline A targets 1
Water 8
Waterproof 6