###############
#\\\\####1\\\\#
#\\\\#*##\\\\\#
L\\\\R A#\\\\\#
###############

Trampoline A targets 1