#######
#  \  #
# *R* #
# * * #
###L###
