 ###
 #*#
 #*#
 #*#
 #*##
##**###
#R.*\L#
#  *###
#  #
#  ##
#   #
#   #
#   #
#   #
#####
